3
16
16
BBBBBBBBBBBBBBBB
BEEEEEEEEEEEEEEB
BBBBBBBBBBEBBBEB
BEEEEEEEEBFBEBEB
BBBBBBBBEBBBEBEB
BEEEEEEBEEEEEBEB
BBBBBBBBEBBBBBEB
BFEEBEEEEBEEEEEB
BBBEEEEEBBBBEBBB
BEEEBBBEEEEEEEEB
BBBBBBBBBBBBBBEB
BBBBBBBBBEEEEEEB
BBBBBBBBBEBBBBBB
BBFEEEEBBEEEEEEB
BBBBBBEEEEEBBBBB
BBBBBBBBBBBBBBBB

