5
16
16
BBBBBBBBBBBBBBBB
BEEEEEEEEEEEEEEB
BBBBBBBBBBEBBBEB
BEEEEEEEEBFBEBEB
BBBBBBBBEBBBEBEB
BFEEEEEBEEEEEBEB
BBBBBBEBEBBBBBEB
BFEEEEEEEBEEEEEB
BBBEEEEEBBBBEBBB
BFEEBBBEEEEEEEEB
BEBBBBBBBBBBBBEB
BEBEEEEBBEEEEEEB
BEBBBBBBBEBBBBBB
BEFEEEEBBEEEEEEB
BBBBBBEEEEEBBBBB
BBBBBBBBBBBBBBBB

