1
8
8
BBBBBBBB
BEEEEEEB
BBBBBBEB
BBEEEEEB
BBEBBBBB
BEEBBBBB
BBEEEEFB
BBBBBBBB

